0000000000000000000000000000
0000027227411111137227200000
0000027227777p77777227200000
0000027227611111157227200000
0000000000000000000000000000